123123
///////////////
/----------2--/
/----2--------/
/--//////-----/
/-------/-----/
/-------------/
/-------------/
/0----1-1-----/
/-------------/
///////////////